+--+--+--+--+
P           |
+  +--+  +  +
|  |     |  |
+  +  +--+--+
|  |        |
+  +--+--+  +
|        | g|
+--+--+--+--+