+--+--+--+--+--+--+--+--+--+--+
p                    |        |
+  +  +  +  +--+--+  +--+t +  +
|  |     |    s   |        | g|
+--+--+--+--+--+--+--+--+--+--+