+--+--+--+--+--+--+--+--+--+--+
p           |                 |
+--+  +--+  +--+--+--+--+  +  +
|     |                    | g|
+--+--+--+--+--+--+--+--+--+--+