+--+--+--+--+--+--+--+--+--+--+
p      t          |           |
+  +--+--+--+--+  +  +--+--+  +
|              |     |       g|
+--+--+--+--+--+--+--+--+--+--+