+--+--+--+--+--+--+--+--+--+--+
p   t       |                 |
+--+  +--+  +--+--+--+--+  +  +
|     |                    | g|
+--+--+--+--+--+--+--+--+--+--+