+--+--+--+--+--+--+--+--+--+--+
p      t          |           |
+  +--+--+--+--+  +  +--+--+  +
|              |  c  |       g|
+--+--+--+--+--+--+--+--+--+--+