+--+--+--+--+--+--+--+--+--+--+
p   t       |              c  |
+--+  +--+  +--+--+--+--+  +  +
|     |    s               | g|
+--+--+--+--+--+--+--+--+--+--+