+--+--+--+--+--+--+--+--+--+--+
p                 |           |
+  +--+--+--+--+  +  +--+--+  +
|              |     |       g|
+--+--+--+--+--+--+--+--+--+--+