+--+--+--+--+--+--+--+--+--+--+
p                   |         |
+  +  +  +  +--+--+  +--+  +  +
|  |     |        |        | g|
+--+--+--+--+--+--+--+--+--+--+